###                 #########
#   ###################   # #
# ####                # # # #
# ################### # # # #
#                     # # # #
##################### # # # #
#   ##                # # # #
# # ## ### ## ######### # # #
# #    #   ##B#         # # #
# # ##             #### # # #
### ##             #### # # #
### ############   ## # # # #
###             ##    # # # #
######  ###             # # #
######  ###                 #
A                       #####
